111111111111111111
1o0000001111111111
1PCE11111111111111
111111111111111111
