111111111111
1P0C0000C011
10C00E000001
111111111111
