1111111111
1000000011
1100001111
1100000111