11111111
1000E001
1E00P0C1
11111111
