1111111111
10000PP001
1C00E00001
1111111111
