111111111
100000P01
1000E0001
111111111
