11111111
100EPC01
10000001
10000001
1111111
