11111111
1000000E1
1PC00001
11111111
