11111111111
10E00000011
1000C000010
100C00000P1
11111111111
